0x60000125d4a0 const 1.09167
0x6000012b4320 var-x
0x600001269e00 const 1.66667
0x600001269090 mul 0x6000012b4320 0x600001269e00
0x60000125e3a0 add 0x60000125d4a0 0x600001269090
0x60000125e530 neg 0x60000125e3a0
0x60000125e2b0 const 0.991667
0x60000125fb60 add 0x60000125e2b0 0x600001269090
0x60000125d590 max 0x60000125e530 0x60000125fb60
0x6000012b42d0 var-y
0x60000126a1c0 mul 0x6000012b42d0 0x600001269e00
0x600001260af0 const 0.441667
0x600001260c80 sub 0x60000126a1c0 0x600001260af0
0x60000125e170 max 0x60000125d590 0x600001260c80
0x6000012623f0 const 0.166667
0x6000012624e0 sub 0x6000012623f0 0x60000126a1c0
0x60000125e3f0 max 0x60000125e170 0x6000012624e0
0x6000012b1400 const 0.175
0x600001260eb0 square 0x600001260c80
0x600001263ac0 const 0.566667
0x600001263c00 add 0x600001263ac0 0x600001269090
0x600001263de0 square 0x600001263c00
0x600001263f20 add 0x600001260eb0 0x600001263de0
0x600001262fd0 sqrt 0x600001263f20
0x60000125d1d0 sub 0x6000012b1400 0x600001262fd0
0x600001260050 const 0.287083
0x600001262bc0 const 1.08333
0x6000012602d0 mul 0x6000012b42d0 0x600001262bc0
0x60000125ce60 sub 0x600001260050 0x6000012602d0
0x6000012637f0 const 0.458333
0x600001260e60 mul 0x6000012b4320 0x6000012637f0
0x60000126b160 const 0.833333
0x60000127e4e0 mul 0x6000012b42d0 0x60000126b160
0x600001261b30 add 0x600001260e60 0x60000127e4e0
0x6000012604b0 const 0.016875
0x60000125ef30 sub 0x600001261b30 0x6000012604b0
0x60000125f340 max 0x60000125ce60 0x60000125ef30
0x600001260a00 const 0.25
0x600001262120 mul 0x6000012b42d0 0x600001260a00
0x600001263b10 const 0.0914583
0x600001261770 add 0x600001263b10 0x600001260e60
0x60000125f700 sub 0x600001262120 0x600001261770
0x60000125db80 max 0x60000125f340 0x60000125f700
0x600001260dc0 sub 0x600001261770 0x600001262120
0x600001261270 sub 0x6000012604b0 0x600001261b30
0x60000125c8c0 max 0x600001260dc0 0x600001261270
0x600001261e50 sub 0x6000012602d0 0x600001260050
0x60000125e4e0 max 0x60000125c8c0 0x600001261e50
0x60000125f2f0 min 0x60000125db80 0x60000125e4e0
0x60000125fc50 neg 0x60000125f2f0
0x60000125d270 max 0x60000125d1d0 0x60000125fc50
0x6000012b4f50 const 0.275
0x600001261ef0 sub 0x600001262fd0 0x6000012b4f50
0x60000125f4d0 max 0x60000125d270 0x600001261ef0
0x600001260230 const 0.391667
0x6000012606e0 sub 0x600001260230 0x60000126a1c0
0x600001260960 const 0.481667
0x6000012623a0 sub 0x60000126a1c0 0x600001260960
0x600001263890 max 0x6000012606e0 0x6000012623a0
0x6000012636b0 const 0.291667
0x600001263250 add 0x6000012636b0 0x600001269090
0x600001261090 max 0x600001263890 0x600001263250
0x600001260550 const 0.791667
0x600001262670 add 0x600001260550 0x600001269090
0x600001263bb0 neg 0x600001262670
0x600001262440 max 0x600001261090 0x600001263bb0
0x60000125d7c0 min 0x60000125f4d0 0x600001262440
0x60000125e760 max 0x60000125d7c0 0x600001261ef0
0x60000125f430 min 0x60000125e3f0 0x60000125e760
0x60000125ecb0 const 0.716667
0x60000125cf00 sub 0x60000126a1c0 0x60000125ecb0
0x60000125da40 const 1.26667
0x60000125fbb0 add 0x60000125da40 0x600001269090
0x60000125d220 square 0x60000125fbb0
0x60000125eb70 add 0x60000125d220 0x600001260eb0
0x60000125caf0 sqrt 0x60000125eb70
0x60000125e9e0 sub 0x60000125caf0 0x6000012b4f50
0x60000125f110 max 0x60000125cf00 0x60000125e9e0
0x60000125ebc0 sub 0x6000012b1400 0x60000125caf0
0x60000125f5c0 max 0x60000125f110 0x60000125ebc0
0x60000125ed50 sub 0x600001260af0 0x60000126a1c0
0x60000125d900 max 0x60000125f5c0 0x60000125ed50
0x60000125f250 const 1.54167
0x60000125ceb0 add 0x60000125f250 0x600001269090
0x60000125eda0 neg 0x60000125ceb0
0x60000125f200 max 0x60000125d900 0x60000125eda0
0x60000125fa70 max 0x60000125f200 0x60000125fb60
0x60000125ce10 min 0x60000125f430 0x60000125fa70
0x60000125ee40 const 1.44167
0x60000125df90 add 0x60000125ee40 0x600001269090
0x60000125ea80 max 0x60000125df90 0x60000125eda0
0x600001262170 const 1.16667
0x6000012622b0 sub 0x60000126a1c0 0x600001262170
0x60000125c730 max 0x60000125ea80 0x6000012622b0
0x60000125fd40 max 0x60000125c730 0x6000012624e0
0x60000125fca0 min 0x60000125ce10 0x60000125fd40
0x60000127def0 const 0.583333
0x60000127df90 mul 0x6000012b4320 0x60000127def0
0x6000012762b0 const 0.166667
0x600001276350 mul 0x6000012b42d0 0x6000012762b0
0x60000127e030 const 0.33375
0x60000127e0d0 add 0x600001276350 0x60000127e030
0x60000127e170 sub 0x60000127df90 0x60000127e0d0
0x60000127e2b0 const 0.223958
0x60000127e350 const 0.375
0x60000127e3f0 mul 0x6000012b4320 0x60000127e350
0x60000127e490 add 0x60000127e3f0 0x60000127e4e0
0x60000127e5d0 sub 0x60000127e2b0 0x60000127e490
0x60000127e9e0 max 0x60000127e170 0x60000127e5d0
0x60000127e6c0 const 0.0877083
0x60000127e760 const 0.208333
0x60000127e800 mul 0x6000012b4320 0x60000127e760
0x60000127e8a0 add 0x60000127e6c0 0x60000127e800
0x60000127e940 sub 0x6000012b42d0 0x60000127e8a0
0x60000127ea80 max 0x60000127e9e0 0x60000127e940
0x60000127eb20 const 0.0877083
0x60000127ebc0 add 0x60000127eb20 0x60000127e800
0x60000127ec60 sub 0x60000127ebc0 0x6000012b42d0
0x60000127ed00 sub 0x60000127e490 0x60000127e2b0
0x60000127ee40 max 0x60000127ec60 0x60000127ed00
0x60000127eda0 sub 0x60000127e0d0 0x60000127df90
0x60000127eee0 max 0x60000127ee40 0x60000127eda0
0x60000127ef80 min 0x60000127ea80 0x60000127eee0
0x60000127f020 neg 0x60000127ef80
0x60000127f0c0 const 0.241667
0x60000127f160 sub 0x60000126a1c0 0x60000127f0c0
0x60000127fde0 max 0x60000127f020 0x60000127f160
0x60000127f200 const 0.0166667
0x60000127f2a0 sub 0x60000127f200 0x60000126a1c0
0x60000127fe80 max 0x60000127fde0 0x60000127f2a0
0x60000127f390 const 1.10833
0x60000127f430 sub 0x600001269090 0x60000127f390
0x60000127ff20 max 0x60000127fe80 0x60000127f430
0x60000127f4d0 const 0.958333
0x60000127f570 sub 0x60000127f4d0 0x600001269090
0x600001260000 max 0x60000127ff20 0x60000127f570
0x60000127f610 const 0.555556
0x60000127f6b0 mul 0x6000012b42d0 0x60000127f610
0x60000127f750 const 0.0805556
0x60000127f7f0 sub 0x60000127f6b0 0x60000127f750
0x60000127f8e0 square 0x60000127f7f0
0x60000127f980 const 1.03333
0x60000127fa20 sub 0x600001269090 0x60000127f980
0x60000127fb10 square 0x60000127fa20
0x60000127fbb0 add 0x60000127f8e0 0x60000127fb10
0x60000127fca0 sqrt 0x60000127fbb0
0x6000012aac60 const 0.075
0x60000127fd40 sub 0x60000127fca0 0x6000012aac60
0x6000012600a0 max 0x600001260000 0x60000127fd40
0x60000125d630 min 0x60000125fca0 0x6000012600a0
0x600001260320 square 0x60000127f160
0x600001260460 const 1.05833
0x600001260500 sub 0x600001269090 0x600001260460
0x600001260690 square 0x600001260500
0x600001261220 add 0x600001260320 0x600001260690
0x6000012612c0 sqrt 0x600001261220
0x6000012609b0 sub 0x6000012612c0 0x6000012aac60
0x60000125ca50 min 0x60000125d630 0x6000012609b0
0x600001261040 sub 0x600001269090 0x60000127def0
0x6000012614f0 square 0x600001261040
0x600001261680 add 0x600001260eb0 0x6000012614f0
0x6000012618b0 sqrt 0x600001261680
0x6000012619f0 sub 0x6000012b1400 0x6000012618b0
0x600001261db0 sub 0x6000012618b0 0x6000012b4f50
0x600001261f40 max 0x6000012619f0 0x600001261db0
0x60000125df40 min 0x60000125ca50 0x600001261f40
0x600001262d50 max 0x6000012622b0 0x6000012624e0
0x600001262620 const 0.183333
0x6000012628a0 sub 0x600001269090 0x600001262620
0x600001262ee0 max 0x600001262d50 0x6000012628a0
0x600001262a30 const 0.0833334
0x600001262b70 sub 0x600001262a30 0x600001269090
0x600001263070 max 0x600001262ee0 0x600001262b70
0x60000125cff0 min 0x60000125df40 0x600001263070
0x6000012632a0 const 0.166667
0x600001263430 add 0x6000012632a0 0x600001269090
0x6000012634d0 neg 0x600001263430
0x6000012638e0 max 0x600001262d50 0x6000012634d0
0x600001275b80 const 0.0666666
0x600001275c20 add 0x600001275b80 0x600001269090
0x600001263700 max 0x6000012638e0 0x600001275c20
0x60000125ddb0 min 0x60000125cff0 0x600001263700
0x600001269b80 const 1.26633
0x600001268690 sub 0x600001269b80 0x600001269090
0x60000126bb10 const 0.383333
0x60000126a530 add 0x60000126bb10 0x60000126a1c0
0x600001268730 max 0x600001268690 0x60000126a530
0x6000012693b0 const 0.483333
0x60000126abc0 add 0x6000012693b0 0x60000126a1c0
0x60000126b0c0 neg 0x60000126abc0
0x600001269f90 max 0x600001268730 0x60000126b0c0
0x60000126bf70 const 1.44133
0x60000126b200 sub 0x600001269090 0x60000126bf70
0x60000126b070 max 0x600001269f90 0x60000126b200
0x60000125ed00 min 0x60000125ddb0 0x60000126b070
0x600001268d70 const 0.933333
0x6000012680f0 add 0x600001268d70 0x60000126a1c0
0x6000012682d0 neg 0x6000012680f0
0x60000126afd0 max 0x6000012682d0 0x600001268690
0x600001269c70 add 0x60000126b160 0x60000126a1c0
0x60000126a3a0 max 0x60000126afd0 0x600001269c70
0x60000126b890 max 0x60000126a3a0 0x60000126b200
0x60000125f0c0 min 0x60000125ed00 0x60000126b890
0x60000126aa80 const 1.44133
0x600001269270 sub 0x60000126aa80 0x600001269090
0x60000126a990 max 0x6000012682d0 0x600001269270
0x60000126a4e0 const 1.54133
0x600001269450 sub 0x600001269090 0x60000126a4e0
0x60000126a300 max 0x60000126a990 0x600001269450
0x60000126a440 const 0.0666666
0x60000126ac60 sub 0x60000126a1c0 0x60000126a440
0x60000126bbb0 max 0x60000126a300 0x60000126ac60
0x60000125d180 min 0x60000125f0c0 0x60000126bbb0
0x60000126a850 const 0.658333
0x600001268780 add 0x60000126a850 0x60000126a1c0
0x600001269bd0 square 0x600001268780
0x60000126bed0 square 0x600001268690
0x6000012688c0 add 0x600001269bd0 0x60000126bed0
0x600001268960 sqrt 0x6000012688c0
0x600001268eb0 sub 0x6000012b1400 0x600001268960
0x600001269ea0 max 0x6000012682d0 0x600001268eb0
0x600001269900 const 1.26633
0x600001268f00 sub 0x600001269090 0x600001269900
0x60000126a670 max 0x600001269ea0 0x600001268f00
0x60000126ad00 max 0x60000126a670 0x60000126ac60
0x60000126b660 sub 0x600001268960 0x6000012b4f50
0x60000126b520 max 0x60000126ad00 0x60000126b660
0x600001269680 const 0.541333
0x60000126bc50 sub 0x600001269680 0x600001269090
0x600001274050 max 0x60000126b520 0x60000126bc50
0x60000125caa0 min 0x60000125d180 0x600001274050
0x600001274460 max 0x6000012682d0 0x60000126ac60
0x600001274190 const 0.891333
0x600001274230 sub 0x600001269090 0x600001274190
0x600001274500 max 0x600001274460 0x600001274230
0x600001274320 const 0.791333
0x6000012743c0 sub 0x600001274320 0x600001269090
0x6000012745a0 max 0x600001274500 0x6000012743c0
0x60000125c780 min 0x60000125caa0 0x6000012745a0
0x600001274910 max 0x6000012682d0 0x60000126a530
0x600001274690 const 0.408333
0x600001274730 sub 0x600001269090 0x600001274690
0x6000012749b0 max 0x600001274910 0x600001274730
0x6000012747d0 const 0.308333
0x600001274870 sub 0x6000012747d0 0x600001269090
0x600001274a50 max 0x6000012749b0 0x600001274870
0x60000125e0d0 min 0x60000125c780 0x600001274a50
0x600001274af0 const 2.38095
0x600001274b90 mul 0x6000012b4320 0x600001274af0
0x600001274c30 const 0.990476
0x600001274cd0 sub 0x600001274b90 0x600001274c30
0x600001275860 max 0x600001274910 0x600001274cd0
0x600001274d70 const 0.440476
0x600001274e10 sub 0x600001274d70 0x600001274b90
0x600001275900 max 0x600001275860 0x600001274e10
0x6000012b5310 const 0.45
0x600001274f00 square 0x6000012680f0
0x600001274fa0 const 2.97619
0x600001275040 mul 0x6000012b4320 0x600001274fa0
0x6000012750e0 const 1.2381
0x600001275180 sub 0x600001275040 0x6000012750e0
0x600001275270 square 0x600001275180
0x600001275310 add 0x600001274f00 0x600001275270
0x600001275400 sqrt 0x600001275310
0x6000012754a0 sub 0x6000012b5310 0x600001275400
0x6000012759a0 max 0x600001275900 0x6000012754a0
0x600001275590 square 0x600001274cd0
0x600001275630 add 0x600001274f00 0x600001275590
0x600001275720 sqrt 0x600001275630
0x6000012b70c0 const 0.55
0x6000012757c0 sub 0x600001275720 0x6000012b70c0
0x600001275a40 max 0x6000012759a0 0x6000012757c0
0x60000125cbe0 min 0x60000125e0d0 0x600001275a40
0x600001275d10 square 0x600001275c20
0x600001275db0 add 0x600001269bd0 0x600001275d10
0x600001275ea0 sqrt 0x600001275db0
0x600001275f40 sub 0x6000012b1400 0x600001275ea0
0x6000012760d0 sub 0x600001275ea0 0x6000012b4f50
0x600001276170 max 0x600001275f40 0x6000012760d0
0x60000125dc20 min 0x60000125cbe0 0x600001276170
0x600001276210 const 0.0933333
0x6000012763f0 add 0x600001276210 0x600001276350
0x600001276490 neg 0x6000012763f0
0x6000012765d0 const 0.147083
0x600001276670 const 0.916667
0x600001276710 mul 0x6000012b4320 0x600001276670
0x6000012767b0 add 0x6000012765d0 0x600001276710
0x600001276850 const 0.416667
0x6000012768f0 mul 0x6000012b42d0 0x600001276850
0x600001276990 sub 0x6000012767b0 0x6000012768f0
0x600001276da0 max 0x600001276490 0x600001276990
0x600001276a80 const 0.583333
0x600001276b20 mul 0x6000012b42d0 0x600001276a80
0x600001276bc0 const 0.10875
0x600001276c60 add 0x600001276bc0 0x600001276710
0x600001276d00 sub 0x600001276b20 0x600001276c60
0x600001276e40 max 0x600001276da0 0x600001276d00
0x6000012389b0 min 0x60000125dc20 0x600001276e40
0x600001276ee0 sub 0x600001276c60 0x600001276b20
0x600001277070 max 0x6000012763f0 0x600001276ee0
0x600001276fd0 sub 0x6000012768f0 0x6000012767b0
0x600001277110 max 0x600001277070 0x600001276fd0
0x600001239d10 min 0x6000012389b0 0x600001277110
0x6000012771b0 const 0.0383333
0x600001277250 add 0x6000012771b0 0x600001276350
0x6000012774d0 max 0x600001276ee0 0x600001277250
0x6000012772f0 const 0.202083
0x600001277390 add 0x6000012772f0 0x600001276710
0x600001277430 sub 0x6000012768f0 0x600001277390
0x600001277570 max 0x6000012774d0 0x600001277430
0x600001238d20 min 0x600001239d10 0x600001277570
0x600001277610 sub 0x600001277390 0x6000012768f0
0x600001277750 max 0x600001276d00 0x600001277610
0x6000012776b0 neg 0x600001277250
0x6000012777f0 max 0x600001277750 0x6000012776b0
0x600001239ae0 min 0x600001238d20 0x6000012777f0
0x600001277890 const 0.66875
0x600001277930 add 0x6000012768f0 0x600001277890
0x6000012779d0 add 0x600001277930 0x600001276710
0x600001277a70 neg 0x6000012779d0
0x600001277cf0 max 0x600001276490 0x600001277a70
0x600001277b10 const 0.707083
0x600001277bb0 add 0x600001276b20 0x600001277b10
0x600001277c50 add 0x600001277bb0 0x600001276710
0x600001277d90 max 0x600001277cf0 0x600001277c50
0x6000012395e0 min 0x600001239ae0 0x600001277d90
0x600001277ed0 max 0x6000012763f0 0x6000012779d0
0x600001277e30 neg 0x600001277c50
0x600001277f70 max 0x600001277ed0 0x600001277e30
0x60000123a620 min 0x6000012395e0 0x600001277f70
0x60000127c230 max 0x600001277250 0x600001277e30
0x60000127c050 const 0.61375
0x60000127c0f0 add 0x6000012768f0 0x60000127c050
0x60000127c190 add 0x60000127c0f0 0x600001276710
0x60000127c2d0 max 0x60000127c230 0x60000127c190
0x60000123a850 min 0x60000123a620 0x60000127c2d0
0x60000127c410 max 0x6000012776b0 0x600001277c50
0x60000127c370 neg 0x60000127c190
0x60000127c4b0 max 0x60000127c410 0x60000127c370
0x60000123b7f0 min 0x60000123a850 0x60000127c4b0
0x60000127c550 const 0.422083
0x60000127c5f0 add 0x60000127c550 0x600001276710
0x60000127c690 sub 0x60000127c5f0 0x6000012768f0
0x60000127c910 max 0x600001276490 0x60000127c690
0x60000127c730 const 0.38375
0x60000127c7d0 add 0x60000127c730 0x600001276710
0x60000127c870 sub 0x600001276b20 0x60000127c7d0
0x60000127c9b0 max 0x60000127c910 0x60000127c870
0x600001239720 min 0x60000123b7f0 0x60000127c9b0
0x60000127ca50 sub 0x60000127c7d0 0x600001276b20
0x60000127cb90 max 0x6000012763f0 0x60000127ca50
0x60000127caf0 sub 0x6000012768f0 0x60000127c5f0
0x60000127cc30 max 0x60000127cb90 0x60000127caf0
0x6000012392c0 min 0x600001239720 0x60000127cc30
0x60000127ceb0 max 0x600001277250 0x60000127ca50
0x60000127ccd0 const 0.477083
0x60000127cd70 add 0x60000127ccd0 0x600001276710
0x60000127ce10 sub 0x6000012768f0 0x60000127cd70
0x60000127cf50 max 0x60000127ceb0 0x60000127ce10
0x60000123ba20 min 0x6000012392c0 0x60000127cf50
0x60000127d090 max 0x6000012776b0 0x60000127c870
0x60000127cff0 sub 0x60000127cd70 0x6000012768f0
0x60000127d130 max 0x60000127d090 0x60000127cff0
0x60000123b110 min 0x60000123ba20 0x60000127d130
0x60000127d1d0 add 0x6000012768f0 0x600001276710
0x60000127d270 const 0.94375
0x60000127d310 add 0x60000127d1d0 0x60000127d270
0x60000127d3b0 neg 0x60000127d310
0x60000127d630 max 0x600001276490 0x60000127d3b0
0x60000127d450 add 0x600001276b20 0x600001276710
0x60000127d4f0 const 0.982083
0x60000127d590 add 0x60000127d450 0x60000127d4f0
0x60000127d6d0 max 0x60000127d630 0x60000127d590
0x60000123b200 min 0x60000123b110 0x60000127d6d0
0x60000127d810 max 0x6000012763f0 0x60000127d310
0x60000127d770 neg 0x60000127d590
0x60000127d8b0 max 0x60000127d810 0x60000127d770
0x60000123b3e0 min 0x60000123b200 0x60000127d8b0
0x60000127db30 max 0x600001277250 0x60000127d770
0x60000127d950 const 0.88875
0x60000127d9f0 add 0x6000012768f0 0x60000127d950
0x60000127da90 add 0x60000127d9f0 0x600001276710
0x60000127dbd0 max 0x60000127db30 0x60000127da90
0x6000012381e0 min 0x60000123b3e0 0x60000127dbd0
0x60000127dd10 max 0x6000012776b0 0x60000127d590
0x60000127dc70 neg 0x60000127da90
0x60000127ddb0 max 0x60000127dd10 0x60000127dc70
0x60000123a1c0 min 0x6000012381e0 0x60000127ddb0
0x60000129c370 const 1e+08
0x600001238730 min 0x60000123a1c0 0x60000129c370